1 2 1 2 1 2 1 2 1 2 
2 1 2 1 2 1 2 1 2 1 
0 0 0 0 0 0 0 0 0 0 
1 0 1 0 1 0 1 0 1 0 
0 6 0 6 0 6 0 6 0 6 
