0 1 5 5 5 5 5 5 1 0 
0 1 3 3 3 3 3 3 1 0 
0 1 3 4 3 3 4 3 1 0 
0 1 3 3 3 3 3 3 1 0 
0 6 6 6 6 6 6 6 6 0 
